gameTitle=迷宫与吃豆人

level=闯关模式
unlimit=无尽模式
online=对战模式
account=账号
share=分享
help=帮助
healthyWarn=抵制不良游戏 拒绝盗版游戏 注意自我保护 谨防受骗上当\n适度游戏益脑 沉迷游戏伤身 合理安排时间 享受健康生活
unlimitGo=开始
onlineGo=开始
showScore=分数
showTitle=称号
showRnak=排行
helpTip=点击任意位置继续
ok=确定
cancel=取消
exit?=退出？
timeTip=剩余时间:
showPassReward=本关奖励
addSpeedSkill=加速
addTimeSkill=加时
mulBeanSkill=分数加倍
showRouteSkill=显示路线

levelItem=关卡{0},星数{1}
unlimitRankSelf=关卡:{0},星数:{1},排名:{2}
unlimitRankItem=排行：{0},名字：{1},星数：{2}
onlineScore=分数:{0}
onlineTitle=段位:{0}
onlineRank=排名:{0}
onlineRankItem=排行:{0},名字:{1},分数:{2},段位:{3}

matching=匹配中...
getServerInfoFail=获取服务器信息失败！
connectServerFail=连接服务器失败！

success=成功
fail=失败

onlineSettleItem=排行:{0},名字:{1},分数:{2},段位:{3}

dataError=数据错误:

guideContent1=引导一
guideContent2=引导二
guideContent3=引导三
guideContent4=引导四