gameTitle=maze and pacman

level=Pass Mode
unlimit=Unlimit Mode
online=Online PvP
account=Account
share=Share
help=Help
packet=packet
shop=shop
healthyWarn=enjoy it!
unlimitGo=GO
onlineGo=GO
showScore=score
showTitle=title
showRnak=rank
helpTip=click to continue
ok=ok
cancel=cancel
exit?=exit?
timeTip=time:
showPassReward=Pass Reward
addSpeedSkill=Accelerate
addTimeSkill=Add Time
mulBeanSkill=Double Score
showRouteSkill=Show Route

levelItem=pass{0},star{1}
unlimitRankSelf=pass:{0},star:{1},rank:{2}
unlimitRankItem=rank:{0},name:{1},star:{2}
onlineScore=score:{0}
onlineTitle=title:{0}
onlineRank=rank:{0}
onlineRankItem=rank:{0},name:{1},score:{2},title:{3}

matching=matching...
getServerInfoFail=get server info fail !
connectServerFail=connect server fialÔºÅ

success=SUCCESS
fail=FAIL

onlineSettleItem=rank:{0},name:{1},score:{2},title:{3}

dataError=data error:

guideContent1=guideContent1
guideContent2=guideContent2
guideContent3=guideContent3
guideContent4=guideContent4

use=use it

itemEnergyIntroduce=energy{0}
itemAddSpeedIntroduce=add speed {0}
itemAddTimeIntroduce=add time {0}
itemMulBeanIntroduce=mul bean{0}
itemShowRouteIntroduce=show route

itemTab=items
suitTab=suit
peckTab=peck

buy=buy
buySuccess=Purchase Success
buyFail=This purchase failed